MMMMMMMMMM
M2HHHHHH1M
MG000000DM
MG000C00DM
MG000000DM
MG00C000DM
MGC00000DM
MG00E00CDM
M3BBBBBB4M
MMMMMMMMMM