MMMMMMMMMMMMMMMMMMMMMMMM
M2HHHHHHHHHHHHHHHHHHHH1M
MGPAAAAAAAAAAAAAA000A0DM
MGAAAAAACAAA00000000A0DM
MGAAA00000AA000CCCCEA0DM
MGAAAAAAAAAAAAAAAA00A0DM
MGAA00000CC000000000A0DM
MGAAAAAAAACAAAAAAAA0A0DM
MG0000CCCCC000000000A0DM
MG0000AA000AA00000AAA0DM
M3BBBBBBBBBBBBBBBBBBBB4M
MMMMMMMMMMMMMMMMMMMMMMMM